0,5,1,2,3,3,5,6,6,5,3,3,2,1,5,1,0,5,1,2,3,3,5,6,6,5,3,3,2,1,5,1,0,5,1,2,3,3,5,6,6,5,3,3,2,1,5,1,0,5,1,2,3,3,5,6,6,5,3,3,2,1,5,1
6,5,7,12,8,12,12,12,12,12,12,11,12,7,5,6,6,5,7,12,8,12,12,12,12,12,12,11,12,7,5,6,6,5,7,12,8,12,12,12,12,12,12,11,12,7,5,6,6,5,7,12,8,12,12,12,12,12,12,11,12,7,5,6
2,12,12,12,12,12,1,3,3,1,12,12,12,12,12,12,12,12,12,12,12,12,1,3,3,1,12,12,12,12,12,12,12,12,12,12,12,12,1,3,3,1,12,12,12,12,12,12,12,12,12,12,12,12,1,3,3,1,12,12,12,12,12,2
9,11,11,12,1,12,5,9,10,5,12,1,12,9,9,11,9,11,11,12,1,12,5,9,10,5,12,1,12,9,9,11,9,11,11,12,1,12,5,9,10,5,12,1,12,9,9,11,9,11,11,12,1,12,5,9,10,5,12,1,12,9,9,11
11,11,9,12,1,12,1,3,3,1,12,1,12,11,9,9,11,11,9,12,1,12,1,3,3,1,12,1,12,11,9,9,11,11,9,12,1,12,1,3,3,1,12,1,12,11,9,9,11,11,9,12,1,12,1,3,3,1,12,1,12,11,9,9
9,11,11,12,12,12,5,9,11,5,12,12,12,9,9,11,9,11,11,12,12,12,5,9,11,5,12,12,12,9,9,11,9,11,11,12,12,12,5,9,11,5,12,12,12,9,9,11,9,11,11,12,12,12,5,9,11,5,12,12,12,9,9,11
2,12,12,12,12,12,12,12,12,12,12,12,12,12,12,12,12,12,12,12,12,12,12,12,12,12,12,12,12,12,12,12,12,12,12,12,12,12,12,12,12,12,12,12,12,12,12,12,12,12,12,12,12,12,12,12,12,12,12,12,12,12,12,2
11,11,9,12,1,12,9,9,11,11,12,1,12,11,9,9,11,11,9,12,1,12,9,9,11,11,12,1,12,11,9,9,11,11,9,12,1,12,9,9,11,11,12,1,12,11,9,9,11,11,9,12,1,12,9,9,11,11,12,1,12,11,9,9
9,11,11,12,1,12,12,12,12,12,12,1,12,9,9,11,9,11,11,12,1,12,12,12,12,12,12,1,12,9,9,11,9,11,11,12,1,12,12,12,12,12,12,1,12,9,9,11,9,11,11,12,1,12,12,12,12,12,12,1,12,9,9,11
2,12,12,12,12,12,1,12,12,1,12,12,12,12,12,12,12,12,12,12,12,12,1,12,12,1,12,12,12,12,12,12,12,12,12,12,12,12,1,12,12,1,12,12,12,12,12,12,12,12,12,12,12,12,1,12,12,1,12,12,12,12,12,2
6,1,7,12,8,12,12,12,12,12,12,11,12,7,1,6,6,1,7,12,8,12,12,12,12,12,12,11,12,7,1,6,6,1,7,12,8,12,12,12,12,12,12,11,12,7,1,6,6,1,7,12,8,12,12,12,12,12,12,11,12,7,1,6
1,1,1,12,3,3,5,6,6,5,3,3,12,1,1,1,1,1,1,12,3,3,5,6,6,5,3,3,12,1,1,1,1,1,1,12,3,3,5,6,6,5,3,3,12,1,1,1,1,1,1,12,3,3,5,6,6,5,3,3,12,1,1,1
0,5,1,12,3,3,5,6,6,5,3,3,12,1,5,1,0,5,1,12,3,3,5,6,6,5,3,3,12,1,5,1,0,5,1,12,3,3,5,6,6,5,3,3,12,1,5,1,0,5,1,12,3,3,5,6,6,5,3,3,12,1,5,1
6,5,7,12,8,12,12,12,12,12,12,11,12,7,5,6,6,5,7,12,8,12,12,12,12,12,12,11,12,7,5,6,6,5,7,12,8,12,12,12,12,12,12,11,12,7,5,6,6,5,7,12,8,12,12,12,12,12,12,11,12,7,5,6
2,12,12,12,12,12,1,3,3,1,12,12,12,12,12,12,12,12,12,12,12,12,1,3,3,1,12,12,12,12,12,12,12,12,12,12,12,12,1,3,3,1,12,12,12,12,12,12,12,12,12,12,12,12,1,3,3,1,12,12,12,12,12,2
9,11,11,12,1,12,5,9,10,5,12,1,12,9,9,11,9,11,11,12,1,12,5,9,10,5,12,1,12,9,9,11,9,11,11,12,1,12,5,9,10,5,12,1,12,9,9,11,9,11,11,12,1,12,5,9,10,5,12,1,12,9,9,11
11,11,9,12,1,12,1,3,3,1,12,1,12,11,9,9,11,11,9,12,1,12,1,3,3,1,12,1,12,11,9,9,11,11,9,12,1,12,1,3,3,1,12,1,12,11,9,9,11,11,9,12,1,12,1,3,3,1,12,1,12,11,9,9
9,11,11,12,12,12,5,9,11,5,12,12,12,9,9,11,9,11,11,12,12,12,5,9,11,5,12,12,12,9,9,11,9,11,11,12,12,12,5,9,11,5,12,12,12,9,9,11,9,11,11,12,12,12,5,9,11,5,12,12,12,9,9,11
2,12,12,12,12,12,12,12,12,12,12,12,12,12,12,12,12,12,12,12,12,12,12,12,12,12,12,12,12,12,12,12,12,12,12,12,12,12,12,12,12,12,12,12,12,12,12,12,12,12,12,12,12,12,12,12,12,12,12,12,12,12,12,2
11,11,9,12,1,12,9,9,11,11,12,1,12,11,9,9,11,11,9,12,1,12,9,9,11,11,12,1,12,11,9,9,11,11,9,12,1,12,9,9,11,11,12,1,12,11,9,9,11,11,9,12,1,12,9,9,11,11,12,1,12,11,9,9
9,11,11,12,1,12,12,12,12,12,12,1,12,9,9,11,9,11,11,12,1,12,12,12,12,12,12,1,12,9,9,11,9,11,11,12,1,12,12,12,12,12,12,1,12,9,9,11,9,11,11,12,1,12,12,12,12,12,12,1,12,9,9,11
2,12,12,12,12,12,1,12,12,1,12,12,12,12,12,12,12,12,12,12,12,12,1,12,12,1,12,12,12,12,12,12,12,12,12,12,12,12,1,12,12,1,12,12,12,12,12,12,12,12,12,12,12,12,1,12,12,1,12,12,12,12,12,2
6,1,7,12,8,12,12,12,12,12,12,11,12,7,1,6,6,1,7,12,8,12,12,12,12,12,12,11,12,7,1,6,6,1,7,12,8,12,12,12,12,12,12,11,12,7,1,6,6,1,7,12,8,12,12,12,12,12,12,11,12,7,1,6
1,1,1,12,3,3,5,6,6,5,3,3,12,1,1,1,1,1,1,12,3,3,5,6,6,5,3,3,12,1,1,1,1,1,1,12,3,3,5,6,6,5,3,3,12,1,1,1,1,1,1,12,3,3,5,6,6,5,3,3,12,1,1,1
0,5,1,12,3,3,5,6,6,5,3,3,12,1,5,1,0,5,1,12,3,3,5,6,6,5,3,3,12,1,5,1,0,5,1,12,3,3,5,6,6,5,3,3,12,1,5,1,0,5,1,12,3,3,5,6,6,5,3,3,12,1,5,1
6,5,7,12,8,12,12,12,12,12,12,11,12,7,5,6,6,5,7,12,8,12,12,12,12,12,12,11,12,7,5,6,6,5,7,12,8,12,12,12,12,12,12,11,12,7,5,6,6,5,7,12,8,12,12,12,12,12,12,11,12,7,5,6
2,12,12,12,12,12,1,3,3,1,12,12,12,12,12,12,12,12,12,12,12,12,1,3,3,1,12,12,12,12,12,12,12,12,12,12,12,12,1,3,3,1,12,12,12,12,12,12,12,12,12,12,12,12,1,3,3,1,12,12,12,12,12,2
9,11,11,12,1,12,5,9,10,5,12,1,12,9,9,11,9,11,11,12,1,12,5,9,10,5,12,1,12,9,9,11,9,11,11,12,1,12,5,9,10,5,12,1,12,9,9,11,9,11,11,12,1,12,5,9,10,5,12,1,12,9,9,11
11,11,9,12,1,12,1,3,3,1,12,1,12,11,9,9,11,11,9,12,1,12,1,3,3,1,12,1,12,11,9,9,11,11,9,12,1,12,1,3,3,1,12,1,12,11,9,9,11,11,9,12,1,12,1,3,3,1,12,1,12,11,9,9
9,11,11,12,12,12,5,9,11,5,12,12,12,9,9,11,9,11,11,12,12,12,5,9,11,5,12,12,12,9,9,11,9,11,11,12,12,12,5,9,11,5,12,12,12,9,9,11,9,11,11,12,12,12,5,9,11,5,12,12,12,9,9,11
2,12,12,12,12,12,12,12,12,12,12,12,12,12,12,12,12,12,12,12,12,12,12,12,12,12,12,12,12,12,12,12,12,12,12,12,12,12,12,12,12,12,12,12,12,12,12,12,12,12,12,12,12,12,12,12,12,12,12,12,12,12,12,2
11,11,9,12,1,12,9,9,11,11,12,1,12,11,9,9,11,11,9,12,1,12,9,9,11,11,12,1,12,11,9,9,11,11,9,12,1,12,9,9,11,11,12,1,12,11,9,9,11,11,9,12,1,12,9,9,11,11,12,1,12,11,9,9
9,11,11,12,1,12,12,12,12,12,12,1,12,9,9,11,9,11,11,12,1,12,12,12,12,12,12,1,12,9,9,11,9,11,11,12,1,12,12,12,12,12,12,1,12,9,9,11,9,11,11,12,1,12,12,12,12,12,12,1,12,9,9,11
2,12,12,12,12,12,1,12,12,1,12,12,12,12,12,12,12,12,12,12,12,12,1,12,12,1,12,12,12,12,12,12,12,12,12,12,12,12,1,12,12,1,12,12,12,12,12,12,12,12,12,12,12,12,1,12,12,1,12,12,12,12,12,2
6,1,7,12,8,12,12,12,12,12,12,11,12,7,1,6,6,1,7,12,8,12,12,12,12,12,12,11,12,7,1,6,6,1,7,12,8,12,12,12,12,12,12,11,12,7,1,6,6,1,7,12,8,12,12,12,12,12,12,11,12,7,1,6
1,1,1,12,3,3,5,6,6,5,3,3,12,1,1,1,1,1,1,12,3,3,5,6,6,5,3,3,12,1,1,1,1,1,1,12,3,3,5,6,6,5,3,3,12,1,1,1,1,1,1,12,3,3,5,6,6,5,3,3,12,1,1,1
0,5,1,12,3,3,5,6,6,5,3,3,12,1,5,1,0,5,1,12,3,3,5,6,6,5,3,3,12,1,5,1,0,5,1,12,3,3,5,6,6,5,3,3,12,1,5,1,0,5,1,12,3,3,5,6,6,5,3,3,12,1,5,1
6,5,7,12,8,12,12,12,12,12,12,11,12,7,5,6,6,5,7,12,8,12,12,12,12,12,12,11,12,7,5,6,6,5,7,12,8,12,12,12,12,12,12,11,12,7,5,6,6,5,7,12,8,12,12,12,12,12,12,11,12,7,5,6
2,12,12,12,12,12,1,3,3,1,12,12,12,12,12,12,12,12,12,12,12,12,1,3,3,1,12,12,12,12,12,12,12,12,12,12,12,12,1,3,3,1,12,12,12,12,12,12,12,12,12,12,12,12,1,3,3,1,12,12,12,12,12,2
9,11,11,12,1,12,5,9,10,5,12,1,12,9,9,11,9,11,11,12,1,12,5,9,10,5,12,1,12,9,9,11,9,11,11,12,1,12,5,9,10,5,12,1,12,9,9,11,9,11,11,12,1,12,5,9,10,5,12,1,12,9,9,11
11,11,9,12,1,12,1,3,3,1,12,1,12,11,9,9,11,11,9,12,1,12,1,3,3,1,12,1,12,11,9,9,11,11,9,12,1,12,1,3,3,1,12,1,12,11,9,9,11,11,9,12,1,12,1,3,3,1,12,1,12,11,9,9
9,11,11,12,12,12,5,9,11,5,12,12,12,9,9,11,9,11,11,12,12,12,5,9,11,5,12,12,12,9,9,11,9,11,11,12,12,12,5,9,11,5,12,12,12,9,9,11,9,11,11,12,12,12,5,9,11,5,12,12,12,9,9,11
2,12,12,12,12,12,12,12,12,12,12,12,12,12,12,12,12,12,12,12,12,12,12,12,12,12,12,12,12,12,12,12,12,12,12,12,12,12,12,12,12,12,12,12,12,12,12,12,12,12,12,12,12,12,12,12,12,12,12,12,12,12,12,2
11,11,9,12,1,12,9,9,11,11,12,1,12,11,9,9,11,11,9,12,1,12,9,9,11,11,12,1,12,11,9,9,11,11,9,12,1,12,9,9,11,11,12,1,12,11,9,9,11,11,9,12,1,12,9,9,11,11,12,1,12,11,9,9
9,11,11,12,1,12,12,12,12,12,12,1,12,9,9,11,9,11,11,12,1,12,12,12,12,12,12,1,12,9,9,11,9,11,11,12,1,12,12,12,12,12,12,1,12,9,9,11,9,11,11,12,1,12,12,12,12,12,12,1,12,9,9,11
2,12,12,12,12,12,1,12,12,1,12,12,12,12,12,12,12,12,12,12,12,12,1,12,12,1,12,12,12,12,12,12,12,12,12,12,12,12,1,12,12,1,12,12,12,12,12,12,12,12,12,12,12,12,1,12,12,1,12,12,12,12,12,2
6,1,7,12,8,12,12,12,12,12,12,11,12,7,1,6,6,1,7,12,8,12,12,12,12,12,12,11,12,7,1,6,6,1,7,12,8,12,12,12,12,12,12,11,12,7,1,6,6,1,7,12,8,12,12,12,12,12,12,11,12,7,1,6
1,1,1,2,3,3,5,6,6,5,3,3,2,1,1,1,1,1,1,2,3,3,5,6,6,5,3,3,2,1,1,1,1,1,1,2,3,3,5,6,6,5,3,3,2,1,1,1,1,1,1,2,3,3,5,6,6,5,3,3,2,1,1,1
