0,0,0,5,2,7,0,0,2,0,10,2,2,6,0,0
0,12,12,12,12,12,12,12,12,12,12,12,12,12,12,12
7,12,2,2,12,0,0,2,1,12,2,3,2,0,8,2
0,12,2,2,12,12,12,12,12,12,10,2,12,12,12,0
2,12,12,12,12,1,0,2,0,12,11,2,12,0,2,2
0,12,0,0,12,2,5,1,2,12,2,7,12,4,9,4
2,12,2,0,12,6,2,8,12,12,2,5,12,0,0,0
1,12,1,2,12,12,12,12,12,12,12,12,12,12,12,0
0,0,0,2,0,2,0,1,12,1,2,0,1,2,0,0
0,12,12,12,12,12,12,12,12,12,12,12,12,12,12,12
3,12,0,2,12,2,2,2,12,12,2,9,9,3,2,11
2,12,6,2,12,12,12,12,12,12,0,2,12,12,12,11
